52 52 49 49 57 57 51 51 57 57 50 50 57 61 50 50 57 49 49 57 51 51 57 57 57 50 50 49 50 50 57 61 61 49 49 51 51 52 50 57 57 50 50 57 52 52 50 50 57 57 
52 54 48 54 56 12 48 48 48 48 48 48 48 48 48 48 48 48 48 48 48 48 48 48 48 48 48 55 48 48 48 48 48 54 48 48 48 54 48 48 48 48 48 48 48 48 48 48 48 52 
52 48 48 48 56 48 48 54 48 48 48 48 48 48 54 48 48 54 48 48 48 48 48 48 48 48 48 48 48 48 48 48 48 48 48 48 48 48 48 48 48 48 48 48 48 48 48 54 48 51 
51 48 48 48 56 48 54 48 48 48 48 48 48 48 48 48 48 48 48 48 48 54 48 48 55 48 48 48 48 48 55 48 48 48 48 48 48 48 54 48 48 54 48 48 48 48 48 54 48 51 
51 56 56 54 52 48 48 54 48 48 48 48 48 48 48 48 48 48 48 48 48 48 48 48 48 48 48 48 48 48 48 48 48 48 48 48 48 48 48 48 48 48 48 48 48 48 48 48 48 52 
52 54 48 48 56 56 56 52 56 56 56 52 56 56 56 56 52 56 56 56 56 56 52 56 56 52 56 56 56 61 56 56 56 52 61 56 56 56 56 52 56 56 56 56 56 56 52 56 48 50 
52 48 48 48 56 48 48 48 56 48 48 56 48 48 48 48 48 48 48 48 56 48 48 54 48 48 48 48 48 56 48 48 48 48 48 48 48 48 48 56 48 48 48 54 48 48 48 56 48 52 
49 48 48 56 61 48 48 55 48 48 48 48 48 48 55 48 48 48 48 48 56 48 48 48 48 48 48 48 48 52 48 55 48 48 48 48 48 48 48 48 48 48 48 48 48 48 48 56 48 52 
49 56 54 48 56 48 48 48 48 48 48 56 48 48 48 54 48 48 55 48 52 48 55 48 48 48 54 48 48 56 48 48 55 48 48 48 54 48 48 56 48 48 48 48 48 48 48 48 48 51 
49 48 48 48 56 48 48 48 48 48 48 56 48 54 55 48 48 48 48 48 56 48 48 48 48 48 48 48 48 56 48 48 48 48 54 48 48 48 48 61 48 54 48 48 54 48 48 56 48 52 
52 48 56 48 56 59 55 48 48 48 48 52 55 48 48 48 48 54 48 48 56 48 48 48 48 54 48 48 48 48 48 48 48 48 48 48 48 48 48 61 48 48 48 48 48 48 48 48 48 51 
52 48 48 48 52 48 48 48 48 48 48 56 48 48 48 54 48 48 48 48 48 48 54 48 48 55 48 48 48 52 48 48 48 54 48 48 48 48 48 56 48 48 48 48 48 48 54 56 59 49 
50 48 54 48 56 48 48 48 48 48 48 56 48 48 48 48 48 48 48 48 56 48 48 48 48 48 48 48 48 56 48 48 48 48 48 48 48 48 60 56 48 56 48 48 48 48 48 56 48 49 
50 48 48 48 56 55 56 56 56 48 56 56 61 56 56 56 56 61 56 56 48 56 56 56 56 56 56 56 56 48 56 56 56 56 52 56 56 52 56 48 56 56 24 56 56 56 56 48 48 50 
52 48 48 48 52 48 48 56 48 48 48 48 48 48 56 48 48 48 48 48 48 48 48 48 48 48 48 58 55 48 48 55 48 48 48 54 48 48 48 48 48 56 48 48 48 48 48 48 54 52 
52 48 48 48 56 48 55 48 48 48 48 48 54 48 48 60 48 48 48 54 48 54 48 48 48 55 48 56 48 48 48 48 48 56 48 48 48 48 48 48 48 48 12 56 48 56 48 48 48 52 
51 48 54 48 56 48 48 48 48 48 56 48 48 48 48 48 48 61 48 48 48 48 48 48 48 48 48 56 48 55 48 56 48 48 48 56 48 48 56 48 48 48 48 48 48 48 48 48 48 52 
50 48 48 48 52 48 54 48 56 48 61 48 55 48 55 56 48 48 48 48 48 48 55 48 48 48 48 52 48 48 48 48 48 48 54 48 48 48 56 55 48 48 48 48 48 48 48 54 56 50 
52 58 58 48 56 48 48 48 48 48 56 48 48 48 48 48 48 61 48 55 48 54 48 48 55 48 48 48 48 48 55 48 54 48 48 48 48 48 48 48 48 48 56 48 54 48 48 48 48 51 
52 48 48 48 56 48 48 48 48 48 48 48 48 48 48 48 48 48 48 48 48 48 48 48 48 48 48 48 56 48 48 48 48 48 56 60 48 48 48 48 48 48 48 48 48 48 56 48 48 51 
49 48 54 56 48 56 56 52 56 52 56 52 56 56 56 52 56 56 52 56 56 52 56 56 56 56 56 56 56 52 56 56 52 56 56 56 56 56 56 52 56 56 56 52 56 56 48 48 48 50 
49 48 48 48 56 48 54 48 48 48 48 54 48 48 48 54 48 48 48 48 48 48 48 48 48 48 48 48 54 48 48 48 48 48 48 48 48 54 48 48 48 48 48 48 48 48 48 56 56 52 
51 56 56 48 48 54 48 48 48 48 48 48 48 48 48 48 48 48 48 48 54 48 48 48 48 54 48 48 48 48 48 48 48 48 54 48 48 48 48 48 48 48 48 48 48 56 56 48 48 52 
51 48 54 48 48 48 56 56 61 56 56 56 56 56 61 56 56 56 56 56 56 56 56 61 56 56 56 61 56 56 56 56 56 52 56 56 56 56 56 56 56 52 56 56 56 56 56 56 56 49 
49 48 48 48 56 48 48 48 48 48 48 54 48 48 48 48 48 48 48 24 48 60 48 48 48 54 48 48 48 48 48 48 48 48 48 54 48 48 48 48 48 48 48 48 48 48 24 48 12 49 
61 57 51 51 57 61 61 50 50 50 51 51 61 49 49 57 57 51 57 50 50 49 51 51 61 61 57 50 51 51 61 61 51 51 57 57 51 51 50 50 57 61 51 61 50 51 57 57 61 61 
52 53 53 53 53 53 53 53 53 53 53 53 53 53 53 53 53 53 53 53 53 53 53 53 53 53 53 53 53 53 53 53 53 53 53 53 53 53 53 53 53 53 53 53 53 53 53 53 53 52 
52 53 53 53 53 53 53 53 53 53 53 53 53 53 53 53 53 53 53 53 53 56 56 56 56 56 56 56 56 56 56 56 56 56 56 56 56 56 56 56 56 56 56 56 56 56 56 56 53 52 
52 53 53 53 53 53 53 53 53 53 53 53 53 53 53 53 53 53 53 61 53 56 53 53 53 53 53 53 53 56 53 53 53 53 53 53 53 53 53 53 53 53 53 53 53 53 53 56 53 52 
52 53 53 53 53 53 53 53 53 53 53 53 53 53 53 53 53 53 53 53 53 56 53 56 53 56 56 56 56 56 56 56 56 56 53 56 56 56 56 56 56 56 56 56 56 56 53 56 53 52 
52 53 53 53 53 53 53 53 53 53 53 53 53 53 53 53 53 53 53 53 53 56 53 56 53 53 53 53 53 53 53 53 53 53 53 53 53 53 53 53 53 53 53 56 53 56 53 56 53 52 
52 53 53 53 53 53 53 53 53 53 53 53 53 53 53 53 53 53 53 61 53 56 53 56 53 56 56 56 56 56 56 56 56 56 56 56 56 56 56 56 56 56 56 56 53 56 53 56 53 52 
52 53 53 53 53 53 53 53 53 53 53 53 53 53 53 53 53 53 53 61 53 56 53 56 53 56 53 53 53 53 53 53 53 53 52 53 53 53 53 53 53 53 53 56 53 53 53 56 53 52 
52 53 53 53 53 53 53 53 53 53 53 53 53 53 53 53 53 53 53 61 53 56 53 56 53 56 53 52 52 52 52 52 52 52 52 52 52 52 52 52 52 52 53 56 53 56 53 56 53 52 
52 53 53 53 53 53 53 53 53 53 53 53 53 53 53 53 53 53 53 53 53 56 53 56 53 53 53 52 53 53 53 53 53 53 53 53 53 53 53 53 53 52 53 53 53 56 53 56 53 52 
52 53 53 53 53 53 53 53 53 53 53 53 53 53 53 53 53 53 53 53 53 56 53 56 56 56 53 52 53 52 52 52 52 52 52 52 52 52 52 52 53 52 53 56 53 56 53 56 53 52 
52 53 53 53 53 53 53 53 53 53 53 53 53 53 53 53 53 53 53 53 53 56 53 56 53 56 52 52 53 52 53 53 53 53 53 53 53 53 53 52 53 52 53 56 53 56 53 56 53 52 
52 53 53 53 53 53 53 53 53 53 53 53 53 53 53 53 53 53 53 61 53 56 53 56 53 56 53 52 52 52 53 52 52 52 52 52 52 52 53 52 53 52 53 56 53 56 56 56 53 52 
52 53 53 53 53 53 53 53 53 53 53 53 53 53 53 53 53 53 53 61 53 56 53 56 53 56 53 52 53 52 53 53 53 53 53 53 53 53 53 52 53 53 53 56 56 56 53 56 53 52 
52 53 53 53 53 53 53 53 53 53 53 53 53 53 53 53 53 53 53 61 53 56 53 56 53 53 53 52 53 52 52 52 52 52 53 52 52 52 52 52 53 52 53 56 53 56 53 56 53 52 
52 53 53 53 53 53 53 53 53 53 53 53 53 53 53 53 53 53 53 53 53 56 53 56 53 56 53 52 53 53 53 53 53 53 53 53 53 53 53 53 53 52 53 56 53 56 53 56 53 52 
52 53 53 53 53 53 53 53 53 53 53 53 53 53 53 53 53 53 53 53 53 56 53 56 53 56 53 52 52 52 52 52 52 52 52 52 52 52 52 52 52 52 52 56 53 53 53 56 53 52 
52 53 53 53 53 53 53 53 53 53 53 53 53 53 53 53 53 53 53 61 53 56 53 56 53 56 53 53 53 53 53 53 53 53 53 53 53 53 53 53 53 53 53 56 53 56 53 56 53 52 
52 53 53 53 53 53 53 53 53 53 53 53 53 53 53 53 53 53 53 53 53 56 53 53 53 56 56 56 56 56 56 56 56 56 56 53 56 56 56 56 56 56 56 56 53 56 53 56 53 52 
52 53 53 53 53 53 53 53 53 53 53 53 53 53 53 53 53 53 53 53 53 56 53 56 53 53 53 56 53 53 53 53 53 53 53 53 53 53 53 53 53 53 53 53 53 56 53 56 53 52 
52 53 53 53 53 53 53 53 53 53 53 53 53 53 53 53 53 53 53 53 53 56 53 56 56 56 56 56 56 56 56 56 56 56 56 56 56 56 56 56 56 56 56 56 56 56 53 56 53 52 
52 53 53 53 53 53 53 53 53 53 53 53 53 53 53 53 53 53 53 61 53 56 53 53 53 56 53 53 53 53 53 53 53 53 53 53 53 53 53 53 53 53 53 53 53 53 53 56 53 52 
52 53 53 53 53 53 53 53 53 53 53 53 53 53 53 53 53 53 53 53 53 56 56 56 56 56 56 56 56 56 56 56 56 56 56 56 56 56 56 56 56 56 56 56 56 56 56 56 53 52 
52 53 53 53 53 53 53 53 53 53 53 53 53 53 53 53 53 53 53 61 53 53 53 53 53 53 53 53 53 53 53 53 53 53 53 53 53 53 53 53 53 53 53 53 53 53 53 53 53 52 
52 52 52 52 52 52 52 52 52 52 52 52 52 52 52 52 52 52 52 52 52 52 52 52 52 52 52 52 52 52 52 52 52 52 52 52 52 52 52 52 52 52 52 52 52 52 52 52 52 52 